.......................C.............................
......................===............................
.........C.........C........C.......................&
............===....=..........C...................===
.......C.........C.......=======.......C...........C.
.....=====.....===.............................===...
.H....................................==....C.......C
====_____________________________=============____===