...........................................C.........
.......................C.............................
....................E.....................===....C...
.C...........C....========............=====...C......
.....C...............C.......=................=......
====.....==....=====..............===.........=......
.H.................E............C   .........C=....&.
========____==============____====__====__===========  