.....................................................
...C................C..............................C.
H..................................................==
=.....................==.............C.....====......
C...................C...............===..............
====..C..........===..........=.............C........
..C..........E................=..C.................&.
=====___=========_____===============____======__====
