.....................................................
.............C................C......................
.................C................................&..
...........====..............==..C................=..
.C......C........===..............................C..
........=...............====.....C.....====.........=
..H............C....E..............................C.
======____====================___=__======___===__===