........C............................................
........==........C................................C.
.....C.........E.............E.............C......==.
...........==========..===========..C.........E......
..C......C......................C.........=======....
......====..........................====.......C.....
..H.............................==.................&.
=====__________________________________________======