.....................................................
.....................................................
...............C..............C......................
..............===......C.........==....C.............
.H..........C........C..............................C
===................===...............====...........=
.C...E.........................C.............C......&
=========__=======_____=====__======______=======__==