.....................................................
....................................C................
C.......................C..............E.............
...C.==......C...........=======..========...........
H..............====........................C.......&.
==..........C........===..............C..........====
...............E............C....................C...
======__=======================____==========__======