.....................................................
....C.........C..............C.......................
.........C....=...........E..........................
....====..............=========............C........C
.H..............===........C.........................
===...C....===.............=.....C........==......===
...................C..E....=........E..............&.
=____=======================__=============____======