.....................................................
.....................................................
........C......................C..................C..
...............................C..............C......
......===..................C..===.............===....
.................==.....................=............
..H......=...C.........C..............C....C......&..
======___======___==__======___==__=====___==__======
