.....................................................
........C.....C.......................C.............C
..H..........===.....................................
=====..===..........E..........C.....===.........==..
................========.................C...........
......==............C............==.........===......
.C........C..................C......E.............&..
====____======___========__================____=====_